11111111111111111111111111111111111111
1P000000000000000000000000001100000111
1000111100000000T000000000000000000011
1111100000000000000000000100001100T001
100000000T0000000000000000000001100001
100011000000011100000T0000000000110001
10011000000001E1000000100000T000010001
101110C0000010001000000000000000011001
10011110000000000000000111000000001001
100000110000T0000001000010000000011001
10000001000000000001100010000000010001
10T0000000000000T00000C000000000110101
10000T000000001000000000000000011001C1
100101010101011000000000000T0001000111
10000000000000000000000000000001000001
10010101010100000001111000000001100001
1000C0T000000000T0000100000000001110C1
10010101010100000000C10000000100001111
1100000000T000001100000000000100T00001
1001100000000000000000T000011110000001
11111111111111111111111111111111111111