111111111111111111111
1P0110000C111100C0001
1001C0000000000000001
100000111100011111001
11000111C000001C00011
100011111111000000001
100111E01100001111111
1C0111000000011100001
111111111111111111111