11111111
1T01PE01
10010C01
11111111