1111111111111111
1P011000000000C1
1001C00011100001
1000001111000001
11000111C0000001
1000111111110001
100111E011000001
1C01110000000011
1111111111111111