1111111
1000001
1P00E01
1000001
100C011
1001101
1111001
1110001
1111111