11111
10P01
10001
10001
10C01
10001
10C01
10001
10C01
10001
10C01
10001
10C01
10001
10C01
10001
10C01
10001
10C01
10001
10C01
10001
10E01
11111